R 720 480
NO ./texture/north.jpeg
SO ./texture/south.jpeg
WE ./texture/west.xpm
EA ./texture/east.jpeg

S ./texture/sprite.jpeg
F 220,100,0
C 225,30,0

11111111
10000201
10E00001
10000201
10001001
10200001
11111111
