R 720 480
NO ./texture/north.jpeg
SO ./texture/south.jpeg
WE ./texture/west.xpm
EA ./texture/east.jpeg

S ./texture/sprite.jpeg
F 220,100,0
C 225,30,0

 11111111111111111111111111111111
100000001000000000110000000000001
 11111111011000001110000002000001
      101001000000000000000000001
111111111011000001110000000000001
100000000011000001110111111111111
11110111111111011100000010001
11110111111111011121010010001
11000000110101011102000010001
10002000000000001100S00010001
10000000000000001101012210001
110000011101010111110111100111
11110111 1110101 101111010001
11111111 1111111 111111111111
